NO ./texture/wall_40_1.xpm
SO ./texture/wall_40_2.xpm
WE ./texture/wall_40_3.xpm
EA ./texture/wall_40_4.xpm

F 220,100,0
C 225,30,0

        1111111111 111111111111111
        1000000000100000000000001
        1011000001110000000000001
        1001000000000000000000001
111111111011000001110000000000001
100000000011000001110111111111111
11110111111111011100000010001
11110111111111011101010010001
11000000110101011100000010001
10000010000000001100000010001
100N0000000000001101010010001
1100000111010101111101011000111
11110111111101011101111010001
11111111111 1111111111111111