NO texture/wall_40_1.xpm
SO texture/wall_40_1.xpm
WE texture/wall_40_1.xpm
EA texture/wall_40_1.xpm




F 200,122,90

C 220,100,0


        1111111111111111111111111111111
        1000000000110000000000001
        10110000011 1000000000001
        1001000000010000000000001
111111111011000001110000000000001
100000000011000001110111111111111
11110111111111011100000010001111
11110111111111011101010010001
110000001101101011100000N100111
100000000000010101100000010001
100000000000000001101010010001111
1100000101010101111101111011
1111011111110101 1011110100011
11111111 1111111 11111111111111