NO texture/wall_40_1.xpm
SO texture/wall_40_2.xpm
WE texture/wall_40_3.xpm   
EA                    texture/wall_40_4.xpm

C 0, 14, 59
F 75, 55, 79



        1111111111111111111111111
        1000000001100011100100001
        10110000011101111000000001
        1001000000000011000000001
111111111011000001110000001100001
100000000011000001110111111111111
11110111111111011100000010101
11110111111111011101010010101
11000000110101011100000010101
10000000000000N01100000010101
10000000000000001101010010101
110000011101010111110111101111
11110111 1110101 101111010101
11111111 1111111 111111111111