NO texture/wall_40_1.xpm
WE texture/wall_40_2.xpm
EA texture/wall_40_3.xpm
SO texture/wall_40_4.xpm

F 200,23,98
C 123,25,240


111111111111111111111111111111111111111111111111111111111111111111111111111111111111
101010101010101010101010101010101010101010101010101010101010101010101010101010101011
101010101010101010101010101010101010101010101010101010101010101010101010101010101011
101010101010101010101010101010101010101010101010101010101010101010101010101010101011
101111111111111111111111111111111111111111111111111111111111111111111111111111111011
100001000111111111111111111111111111111111111111111111111111111111111111111111111011
100001000111111111111111111111111111111111111111111111111111111111111111111111111011
100001000111111111111111111111111111111111111111111111111111111111111111111111111011
111111111111111111111111111111111111111111111111111111111111111111111111111111111011
100001000111111111111111111111111111111111111111111111111111111111111111111111111011
100001000111111111111111111111111111111111111111111111111111111111111111111111111011
100001000111111111111111111111111111111111111111111111111111111111111111111111111011
111111111111111111111111111111111111111111111111111111111111111111111111111111111011
100E01000111111111111111111111111111111111111111111111111111111111111111111111111011
100001000111111111111111111111111111111111111111111111111111111111111111111111111011
100001000111111111111111111111111111111111111111111111111111111111111111111111111011
111111111111111111111111111111111111111111111111111111111111111111111111111111111011
100001000111111111111111111111111111111111111111111111111111111111111111111111111011
100001000111111111111111111111111111111111111111111111111111111111111111111111111011
100001000111111111111111111111111111111111111111111111111111111111111111111111111011
111111111111111111111111111111111111111111111111111111111111111111111111111111111011
100001000111111111111111111111111111111111111111111111111111111111111111111111111011
100001000111111111111111111111111111111111111111111111111111111111111111111111111011
100001000111111111111111111111111111111111111111111111111111111111111111111111111011
111111111111111111111111111111111111111111111111111111111111111111111111111111111011
100001000111111111111111111111111111111111111111111111111111111111111111111111111011
100001000111111111111111111111111111111111111111111111111111111111111111111111111011
100001000111111111111111111111111111111111111111111111111111111111111111111111111011
111111111111111111111111111111111111111111111111111111111111111111111111111111111011
100001000111111111111111111111111111111111111111111111111111111111111111111111111011
100001000111111111111111111111111111111111111111111111111111111111111111111111111011
100001000111111111111111111111111111111111111111111111111111111111111111111111111011
111111111111111111111111111111111111111111111111111111111111111111111111111111111111
