NO           texture/wall_40_1.xpm
SO       texture/wall_40_2.xpm
WE         texture/wall_40_3.xpm   
EA          texture/wall_40_4.xpm

C 0, 14, 59
F 75, 55, 79



1111111
1N00001
1111111