NO texture/wall_40_1.xpm
WE texture/wall_40_2.xpm
EA texture/wall_40_3.xpm
SO texture/wall_40_4.xpm

F 200,23,98
C 123,25,240


11111111111
10101010101
10101010101
10E01010101
10111111111
10000100011
11111111111
