NO ./path_to_the_north_textur
SO ./path_to_the_south_texture
WE ./path_to_the_west_texture
EA ./path_to_the_east_texture




F 200,122,90

C 220,100,0


        1111111111111111111111111
        1000000000110000000000001
        10110000011 1000000000001
        1001000000010000000000001
111111111011000001110000000000001
100000000011000001110111111111111
11110111111111011100000010001111
11110111111111011101010010001
1100000011011010111000000100111
10000000000E010001100000010001
10000000000000001101010010001111
11000001010101011111011110011101
1111011111110101 101111010001111
11111111 1111111 111111111111